1111111111111111111111111111111111111111111111
110000CC0000110000CC01100110000CC0000110011011
1111011101101101111101001110111110110110001P11
1111011100001101111100011110000110110110101011
11E1011101101101111101001111110110110110100011
110001110110CC00001101100CC0000110000CC0110011
1111111111111111111111111111111111111111111111